1111111111
1222222221
1222222221
1222220221
1222322221
1222422221
1222222221
1222222221
1222222221
1111111111
