1111111111
1222222221
1222222341
1222220221
1222222221
1222222221
1222222221
1222222221
1222222221
1111111111
