1111111111
1222222221
1222222221
1222222221
1222222221
1222222221
1222222221
1222222221
1220222341
1111111111
